++++++++++-++++++++++
+.........C.........+
+....!.........!....+
+....!.........!....+
+....!.........!....+
+..............IM...+
+..R................+
<.........S.........>
+...................+
+.................WW+
+..............GGGGG+
+.....!!.!!!.!!.....+
+................HHH+
+...................+
++++++++++=++++++++++