+++++++++++++++++++++
+...................+
+...................+
+...................+
+...................+
+...................+
+.........S.........+
+...................+
+..R...........C....+
+...................+
+...................+
+...................+
+...................+
+...................+
+++++++++++++++++++++