++++--++++
+.!!!!!!.+
+........+
<........>
<X......X>
+...??...+
+.!!!!!!E+
++++==++++