++++++++++-++++++++++
+...................+
+....!.........!.Y..+
+....!.........!....+
+....!...C.C...!....+
+..............I....+
+...................+
<.........S.........>
+...................+
+.....R...........WW+
+..............GGGGG+
+.....!!.!!!.!!.....+
+................HHH+
+...................+
++++++++++=++++++++++