++++++++++-++++++++++
+...................+
+....!.........!.Y..+
+....!.........!....+
+....!.........!....+
+..............I....+
+...................+
<.........S.Y.......>
+...................+
+...................+
+...................+
+.....!!.!!!.!!.....+
+..........C........+
+...................+
++++++++++=++++++++++