++++++++++-++++++++++
+...................+
+....!....R....!....+
+....!.........!....+
+....!.........!....+
+.........O.........+
+...................+
<......O..S..O......>
+...................+
+.........O.........+
+...................+
+.....!!.....!!.....+
+...................+
+...................+
++++++++++=++++++++++