++++++++++-++++++++++
+...................+
+..............!....+
+.....!........!....+
+..............!....+
+...................+
+...................+
<.........S.........>
+...................+
+...R..........C....+
+...................+
+...................+
+...................+
+...................+
++++++++++=++++++++++