++++++++++-++++++++++
+...................+
+....!.........!.Y..+
+....!.........!....+
+....!.........!....+
+..............I....+
+...................+
<.........S.........>
+...O...............+
+...................+
+.........P.........+
+.....!!.!!!.!!.....+
+...................+
+...................+
++++++++++=++++++++++