++++++++++-++++++++++
+...................+
+....!....C....!....+
+....!.........!....+
+....!.........!....+
+...................+
+...................+
<.........S.........>
+...................+
+...................+
+...................+
+.....!!.!!!.!!.....+
+.........R.........+
+...................+
++++++++++=++++++++++