++++++++++-++++++++++
+...................+
+....!.........!....+
+....!.........!....+
+....!.........!....+
+...................+
+...................+
<.........S.........>
+...................+
+.....R.....WWWWWW..+
+.......GGGGGGGGGG..+
+.....!!.!!!.!!.....+
+.............HHH...+
+...................+
++++++++++=++++++++++