++++++++++
+........+
+.!!!!!!.+
+........+
+S..  ..X+
+....?...+
+.!.! !.!+
+!!!!!!!!+

