+++++++++++++++++++++
+..!................+
+...................+
+....!........!.....+
+.............!.....+
+...!.........!.....+
+.........S.........+
+...................+
<.........S.........>
+...................+
+..............C....+
+...................+
+...................+
+...................+
+...................+
++++++++++=++++++++++