++++++++++-++++++++++
+...................+
+....!.........!.Y..+
+....!.........!....+
+....!.........!....+
+..............I....+
+..C................+
<.........S.........>
+...................+
+.........E.......WW+
+..............GGGGG+
+.....!!.!!!.!!.....+
+................HHH+
+...................+
++++++++++=++++++++++