++++++++++-++++++++++
+...................+
+....!.........!.Y..+
+....!.........!....+
+....!.........!....+
+..............II...+
+...................+
<.........S.........>
+...................+
+...................+
+......C............+
+...................+
+...................+
+...................+
++++++++++=++++++++++