+++++++++++
+.........+
+.!!...!!.+
+.!.....!.+
+....S....+
+.!.....!.+
+.!!...!!.+
+.........+
+++++++++++