+++++++++++++++++++++
+..!................+
+...................+
+....!........!.....+
+.............!.....+
+...!.........!.....+
+.........S.........+
+...................+
+..R...........C....+
+...................+
+...................+
+...................+
+...................+
+...................+
+++++++++++++++++++++