++++++++++-++++++++++
+...................+
+....!....B....!....+
+....!.........!....+
+....!.........!....+
+...................+
+...................+
<.........S.........>
+...................+
+.....R.........H...+
+...................+
+.....!!.!!!.!!.....+
+...................+
+...................+
++++++++++=++++++++++