++++++++++-++++++++++
+............R......+
+....!.........!.Y..+
+....!.........!....+
+....!.R.......!....+
+..............I....+
+..R................+
<.........S.........>
+..R................+
+.................WW+
+..............GGGGG+
+.....!!.!!!.!!.....+
+................HHH+
+...................+
++++++++++=++++++++++