++++++++++-++++++++++
+...................+
+....!.........!.Y..+
+....!.........!....+
+....!.........!....+
+..............IM...+
+..R................+
<..R......S.........>
+..R................+
+.................WW+
+..............GGGGG+
+.....!!.!!!.!!.....+
+................HHH+
+...................+
++++++++++=++++++++++