++++++++++-++++++++++
+...................+
+....!B........!.Y..+
+....!.........!....+
+....!.........!....+
+..............I....+
+...................+
<.........S.........>
+...................+
+.................WW+
+..............GGGGG+
+.....!!.!!!.!!.....+
+................HHH+
+...................+
++++++++++=++++++++++