++++++++++-++++++++++
+...................+
+.!............!....+
+...!.!........!....+
+..............!....+
+...................+
+...!...............+
<.........S.........>
+...................+
+...................+
+...................+
+...................+
+....R.........C....+
+...................+
++++++++++=++++++++++