++++++++++-++++++++++
+...................+
+....!.........!....+
+....!.........!....+
+....!I.......I!....+
+...................+
+...................+
<......P..S.........>
+...................+
+...................+
+....!I.......I!....+
+....!.........!....+
+....!.........!....+
+.........P.........+
++++++++++=++++++++++