V+++++++++-+++++++++B
LQTTTTTTTTTTTTTTTTTWF
LP...!.........!...YF
LP...!.........!...YF
LP...!.........!...YF
LP.................YF
LP.................YF
<P........S........Y>
LP.................YF
LP.................YF
LP.................YF
LP....!!..C..!!....YF
LP.................YF
LZUUUUUUUUUUUUUUUUUXF
MDDDDDDDDD=DDDDDDDDDN