++++++++++-++++++++++
+...................+
+....!.........!....+
+....!.........!....+
+....!.........!....+
+..............IM...+
+...................+
<..C......S.........>
+..C................+
+..C........WWWWWW..+
+.......GGGGGGGGGG..+
+...................+
+................HHH+
+...................+
++++++++++=++++++++++