++++++++++
+........+
+.!!!!!!.+
+........+
+S......X+
+....?...+
+.!.!.!.!+
+!!!!!!!!+

