++++++++++-++++++++++
+...................+
+...................+
+....!.........!....+
+...!...........!...+
+...................+
+...................+
<.........S.........>
+...................+
+..P....PPPPPPP.....+
+...!...PPP.....!...+
+....!.........!....+
+...................+
+...................+
++++++++++=++++++++++