++++++++++
+.!!!!!!.+
+........+
+........+
+X......X+
+...??...+
+.!!!!!!.+
++++++++++