++++++++++-++++++++++
+...................+
+.!............!....+
+...!.!........!....+
+..............!....+
+...!...............+
+...................+
<.........S.........>
+...................+
+..............C....+
+...................+
+...................+
+...................+
+...................+
++++++++++=++++++++++