++++++++++
+........+
+.!!!!!!.+
+........+
+S......X+
+........+
+.!.! !.!+
+!!!!!!!!+
+????????+
++++++++++
