++++++++++-++++++++++
+...................+
+.!............!....+
+.....!........!....+
+..............!....+
+...!...............+
+...................+
<.........S.........>
+...................+
+...R..........C....+
+...................+
+...................+
+...................+
+...................+
++++++++++=++++++++++