++++--++++
+.!!!!!!.+
+........+
<........>
<X......X>
+...??...+
+.!!!!!!C+
++++==++++