++++++++++-++++++++++
+...................+
+....!.........!....+
+....!.........!....+
+....!I.......I!....+
+...................+
+...................+
<......P..S......GG.>
+...............GGKG+
+................GG.+
+....!I.......I!....+
+....!.........!....+
+....!.........!....+
+...................+
++++++++++=++++++++++