++++++++++-++++++++++
+...................+
+....!....R....!....+
+....!.........!....+
+....!.........!....+
+..............R....+
+...................+
<.........S.........>
+...................+
+.....R.........H...+
+...................+
+.....!!.!!!.!!.....+
+...................+
+...................+
++++++++++=++++++++++