++++++++++-++++++++++
+...................+
+....!.........!.Y..+
+....!.........!....+
+....!.........!....+
+..............I....+
+..R............C...+
<.........S.........>
+..R............C...+
+.................WW+
+..............GGGGG+
+.....!!.!!!.!!.....+
+................HHH+
+...................+
++++++++++=++++++++++