++++++++++-++++++++++
+...................+
+....!.........!....+
+....!.........!....+
+....!.........!....+
+..R......R....IM...+
+...................+
<..R......S.........>
+...................+
+..R........WWWWWW..+
+.......GGGGGGGGGG..+
+.....!!.!!!.!!.....+
+.............HHHHHH+
+...................+
++++++++++=++++++++++