V+++++++++-+++++++++B
LQTTTTTTTTTTTTTTTTTWF
LP........R........YF
LP.................YF
LP.................YF
LP.................YF
LP.................YF
<P........S........Y>
LP.................YF
LP.................YF
LP.................YF
LP.................YF
LP.................YF
LZUUUUUUUUUUUUUUUUUXF
MDDDDDDDDD=DDDDDDDDDN