++++++++++-++++++++++
+...................+
+....!.........!....+
+....!.........!....+
+....!.........!....+
+..............IM...+
+...................+
<.........S.........>
+...................+
+..B........WWWWWW..+
+.......GGGGGGGGGG..+
+.....!!.!!!.!!.....+
+................HHH+
+...................+
++++++++++=++++++++++