++++++++++-++++++++++
+...................+
+....!.........!....+
+....!.........!....+
+....!I.......I!....+
+...................+
+...................+
<.........S.........>
+...................+
+...................+
+....!I.......I!....+
+....!.........!....+
+....!.........!....+
+...................+
++++++++++=++++++++++