++++++++++-++++++++++
+...................+
+....!.........!....+
+....!.........!....+
+....!.........!....+
+..............IM...+
+...................+
<.........S.........>
+.....RR............+
+.....R.....WWWWWW..+
+.......GGGGGGGGGG..+
+.....!!.!!!.!!.....+
+.............HHH...+
+...................+
++++++++++=++++++++++