++++++++++-++++++++++
+...................+
+....!....R....!....+
+....!.........!....+
+....!.........!....+
+..............R....+
+...................+
<.........S.........>
+...................+
+.....R.............+
+.......GGGGGGGGGG..+
+.....!!.!!!.!!.....+
+.............HHH...+
+...................+
++++++++++=++++++++++