++++++++++
+.!!!!!!.+
+........+
+........+
+S......X+
+...??...+
+.!!!!!!.+
++++++++++