++++++++++-++++++++++
+...................+
+....!.........!....+
+....!.........!....+
+....!.........!....+
+...................+
+...................+
<.........S.........>
+...................+
+...............H...+
+.....B.............+
+...................+
+...................+
+...................+
++++++++++=++++++++++