++++++++++-++++++++++
+...................+
+....!....R....!....+
+....!.........!....+
+....!.........!....+
+...................+
+...................+
<..B......S....R....>
+...................+
+...................+
+...................+
+.....!!.!!!.!!.....+
+.........R.........+
+...................+
++++++++++=++++++++++