++++++++++-++++++++++
+...................+
+..............!.Y..+
+....B.........!....+
+..............!....+
+..............I....+
+...................+
<.........S.........>
+...................+
+.................WW+
+..............GGGGG+
+...................+
+................HHH+
+...................+
++++++++++=++++++++++