++++++++++-++++++++++
+...................+
+...................+
+...................+
+...................+
+...................+
+...................+
<.........S.........>
+...................+
+..............C....+
+...................+
+...................+
+...................+
+...................+
+...................+
++++++++++=++++++++++