++++++++++-++++++++++
+...................+
+....!.........!....+
+....!.........!....+
+....!.........!....+
+..C...........IM...+
+...................+
+...................+
<..B......S.........>
+...................+
+...........WWWWWW..+
+.......GGGGGGGGGG..+
+.....!!.!!!.!!.....+
+.............HHHHHH+
+...................+
++++++++++=++++++++++