++++++++++-++++++++++
+...................+
+...................+
+...................+
+...................+
+...................+
+...................+
<.........S.........>
+...................+
+...................+
+...................+
+...................+
+...................+
+...................+
++++++++++=++++++++++