++++++++++-++++++++++
+...W...........W...+
+....W...WWW...W....+
+.....W.WP.PW.W.....+
+......W.....W......+
+.....W.W.W.W.W.....+
+....WP..W.W..PW....+
<....W..W.W.W..W....>
+....WP..W.W..PW....+
+.....W.W.W.W.W.....+
+......W.....W......+
+.....W.WP.PW.W.....+
+....W...WWW...W....+
+...W...........W...+
++++++++++=++++++++++