++++++++++-++++++++++
+...................+
+...................+
+.....!!!...!!!.....+
+....!.........!....+
+...!..!.....!..!...+
+...................+
<.........V.........>
+...................+
+...!..!.....!..!...+
+....!.........!....+
+.....!!!...!!!.....+
+...................+
+...................+
++++++++++=++++++++++