+++++++++++++++++++++
+...................+
+.OOOOOOOOOOOOOOOOO.+
+.O...............O.+
+.O...............O.+
+.O...............O.+
+.O...............O.+
+.O..I....S....I..O.+
+.O...............O.+
+.O...............O.+
+.O.......H.......O.+
+.O...............O.+
+.OOOOOOOOOOOOOOOOO.+
+...................+
+++++++++++++++++++++