++++++++++-++++++++++
+...................+
+...................+
+...................+
+...................+
+...................+
+...................+
<....I.........I....>
+...................+
+...................+
+...................+
+...................+
+...................+
+...................+
++++++++++=++++++++++