++++++++++-++++++++++
+!HHHHHHHH.HHHHHHHH!+
+!H!!!!!!!.!!!!!!!H!+
+!H!.!T.......F!!!H!+
+!H!!D!!!!.!!!!D!!H!+
+!H!!.!.......!.!!H!+
+!H!!.!.......!.!!H!+
<...................>
+!H!!.!.......!.!!H!+
+!H!!.!.......!.!!H!+
+!H!!U!!!!.!!!!U!!H!+
+!H!.!T.......F!.!H!+
+!H!!!!!!!.!!!!!!!H!+
+!HHHHHHHH.HHHHHHHH!+
++++++++++=++++++++++