++++++++++-++++++++++
+!HHHHHHH...HHHHHHH!+
+!H!!!!!!...!!!!!!H!+
+!H!!!!!!.....F!!!H!+
+!H!D!T.....!!!D!!H!+
+!H!.!!!!...!!!.!!H!+
+...................+
<...................>
+...................+
+!H!!.!!!...!!!!.!H!+
+!H!!U!!!.....F!U!H!+
+!H!.!T.....!!!!!!H!+
+!H!!!!!!...!!!!!!H!+
+!HHHHHHH...HHHHHHH!+
++++++++++=++++++++++