++++++++++-++++++++++
+...................+
+......!.....!......+
+.!!!!!!.....!!!!!!.+
+..!.............!..+
+..!...........X.!..+
+..!.Z...........!..+
<..!...........X.!..>
+..!.Z...........!..+
+..!...........X.!..+
+..!.............!..+
+.!!!!!.......!!!!!.+
+.....!.......!.....+
+...................+
++++++++++=++++++++++