++++++++++-++++++++++
+...................+
+.R...............R.+
+....!!.......!!....+
+....!.........!....+
+...................+
+...................+
<.........C.........>
+...................+
+...................+
+....!.........!....+
+....!!.......!!....+
+.R...............R.+
+...................+
++++++++++=++++++++++