++++++++++-++++++++++
+!!...............!!+
+!.................!+
+...................+
+.........Q.........+
+...................+
+....HHHHHHHHHHH....+
<...HHHHHHHHHHHHH...>
+....HHHHHHHHHHH....+
+...................+
+.........Q.........+
+...................+
+!.................!+
+!!...............!!+
++++++++++=++++++++++