++++++++++-++++++++++
+!!...............!!+
+!.................!+
+...................+
+...................+
+.........R.........+
+....HHHHHHHHHHH....+
<...HHHHHHQHHHHHH...>
+....HHHHHHHHHHH....+
+.........R.........+
+...................+
+...................+
+!.................!+
+!!...............!!+
++++++++++=++++++++++