++++++++++-++++++++++
+......!.....!......+
+..I...!.....!...!..+
+.....!.......!.....+
+....!.........!....+
+!!!!.....O.....!!!!+
+........OOO........+
<.......OOQOO.......>
+........OOO........+
+!!!!.....O.....!!!!+
+....!.........!....+
+.....!.......!.....+
+..!...!.....!...I..+
+......!.....!......+
++++++++++=++++++++++