++++++++++-++++++++++
+!!!.............!!!+
+!!...............!!+
+!.................!+
+.....R.......R.....+
+....P.........P....+
+...................+
<...................>
+...................+
+....P.........P....+
+.....R.......R.....+
+!.................!+
+!!...............!!+
+!!!.............!!!+
++++++++++=++++++++++