++++++++++-++++++++++
+...................+
+...................+
+...................+
+...V.....!.........+
+.........!.........+
+.........!.........+
<.....!!!!!!!!!.....>
+.........!.........+
+.........!.........+
+.........!.....V...+
+...................+
+...................+
+...................+
++++++++++=++++++++++