++++++++++-++++++++++
+GGGGGGGG...GGGGGGGG+
+GGGGGGGG...GGGGGGGG+
+GGGGGGGG...GGGGGGGG+
+GGGGGGGGAAAGGGGGGGG+
+GGGGGGGGGGGGGGGGGGG+
+...AGGGGGGGGGGGA...+
<...AGGKGKGKGKGGA...>
+...AGGGGGGGGGGGA...+
+GGGGGGGGGGGGGGGGGGG+
+GGGGGGGGAAAGGGGGGGG+
+GGGGGGGG...GGGGGGGG+
+GGGGGGGG...GGGGGGGG+
+GGGGGGGG...GGGGGGGG+
++++++++++=++++++++++