++++++++++-++++++++++
+GGGGGGGG...GGGGGGGG+
+GAAGGGGG...GGGGGAAG+
+GAGGGGGG...GGGGGGAG+
+GGGGGGGGAAAGGGGGGGG+
+GGGGGGGGGGGGGGGGGGG+
+...AGGGGGGGGGGGA...+
<...AGGKGKGKGKGGA...>
+...AGGGGGGGGGGGA...+
+GGGGGGGGGGGGGGGGGGG+
+GGGGGGGGAAAGGGGGGGG+
+GAGGGGGG...GGGGGGAG+
+GAAGGGGG...GGGGGAAG+
+GGGGGGGG...GGGGGGGG+
++++++++++=++++++++++