++++++++++-++++++++++
+.....AA.....AA.....+
+....A.........A....+
+...A...........A...+
+..A......G......A..+
+.A...C...G....C..A.+
+A........G........A+
<...GGGGGGGGGGGGG...>
+A........G........A+
+.A...C...G....C..A.+
+..A......G......A..+
+...A...........A...+
+....A.........A....+
+.....AA.....AA.....+
++++++++++=++++++++++