++++++++++-++++++++++
+.....!!.....!!.....+
+....!.........!....+
+...!...........!...+
+..!......G......!..+
+.!...C...G....C..!.+
+!........G........!+
<...GGGGGGGGGGGGG...>
+!........G........!+
+.!...C...G....C..!.+
+..!......G......!..+
+...!...........!...+
+....!.........!....+
+.....!!.....!!.....+
++++++++++=++++++++++