++++++++++-++++++++++
+.....!!.....!!.....+
+....!.........!....+
+...!...........!...+
+..!.............!..+
+.!.......G....C..!.+
+!........G........!+
<....GGGGGGGGGGG....>
+!........G........!+
+.!..C....G.......!.+
+..!.............!..+
+...!...........!...+
+....!.........!....+
+.....!!.....!!.....+
++++++++++=++++++++++