+++++++++++++++++++++
+...................+
+...................+
+....!!!!!!!!!!!....+
+...................+
+...................+
+...................+
+.........E.........+
+...................+
+...................+
+...................+
+.....!!!!!!!!!!....+
+...................+
+...................+
+++++++++++++++++++++