+++++++++++
+.........+
+.........+
+.........+
+....X....+
+.........+
+.........+
+.........+
+++++++++++