++++++++++-++++++++++
+...................+
+...................+
+....!!!!!!!!!!!....+
+...................+
+...................+
+...................+
<.........E.........>
+...................+
+...................+
+...................+
+....!!!!!!!!!!!....+
+...................+
+...................+
++++++++++=++++++++++