++++++++++-++++++++++
+...................+
+....!.........!....+
+....!.........!....+
+.....B.............+
+...................+
+...................+
<.........E.........>
+...................+
+...................+
+...................+
+.....!!.!!!.!!.....+
+...................+
+...................+
++++++++++=++++++++++