++++--++++
+........+
+........+
<....X...>
<....X...>
+........+
+........+
++++==++++