V+++++++++-+++++++++B
LQTTTTTTTTTTTTTTTTTWF
LP.................YF
LP.................YF
LP...!!!!!!!!!!!...YF
LP.................YF
LP.................YF
<P........E........Y>
LP.................YF
LP.................YF
LP...!!!!!!!!!!!...YF
LP.................YF
LP.................YF
LZUUUUUUUUUUUUUUUUUXF
MDDDDDDDDD=DDDDDDDDDN