++++++++++
+.........
+.........
+....S....
+....S....
+.........
+.........
++++++++++