++++++++++-++++++++++
+...................+
+....!.........!....+
+...!...........!...+
+..!.!....P....!.!..+
+...................+
+...................+
<......P..R..P......>
+...................+
+...................+
+..!.!....P....!.!..+
+...!...........!...+
+....!.........!....+
+...................+
++++++++++=++++++++++