++++++++++-++++++++++
+OOOOO.........OOOOO+
+OOOO...........OOOO+
+OOO.............OOO+
+OO...............OO+
+O.................O+
+...................+
<.......2.2.2.......>
+...................+
+O.................O+
+OO...............OO+
+OOO.............OOO+
+OOOO...........OOOO+
+OOOOO.........OOOOO+
++++++++++=++++++++++