++++++++++-++++++++++
+...................+
+.OOO...........OOO.+
+.OO.....OOO.....OO.+
+.O...............O.+
+...................+
+...................+
<......R..C..R......>
+...................+
+...................+
+.O...............O.+
+.OO.....OOO.....OO.+
+.OOO...........OOO.+
+...................+
++++++++++=++++++++++