++++++++++-++++++++++
+...................+
+...................+
+..OOO.........OOO..+
+..O......2......O..+
+..O.............O..+
+.........C.........+
<...................>
+.........C.........+
+..O.............O..+
+..O......2......O..+
+..OOO.........OOO..+
+...................+
+...................+
++++++++++=++++++++++