++++++++++-++++++++++
+...................+
+...................+
+...................+
+...................+
+...................+
+...................+
<...................>
+......B............+
+...................+
+...................+
+...................+
+...................+
+...................+
++++++++++=++++++++++