++++++++++-++++++++++
+...................+
+...................+
+...................+
+...................+
+...................+
+...................+
<...................>
+...................+
+...................+
+...................+
+...................+
+...................+
+...................+
++++++++++=++++++++++