++++++++++-++++++++++
+!!.................+
+!..................+
+...................+
+...................+
+.......OOOOO.......+
+.......OOOOO.......+
<.......OOIOO.......>
+.......OOOOO.......+
+.......OOOOO.......+
+...................+
+...................+
+..................!+
+.................!!+
++++++++++=++++++++++