++++++++++-++++++++++
+!!.................+
+!2.................+
+...................+
+...................+
+.......OOOOO.......+
+.......OOOOO.......+
<.......OOIOO.......>
+.......OOOOO.......+
+.......OOOOO.......+
+...................+
+...................+
+.................2!+
+.................!!+
++++++++++=++++++++++