++++++++++-++++++++++
+...................+
+.................R.+
+...!!!!!...........+
+...!!I!!...........+
+...!!!!!...........+
+........Q..........+
<...................>
+..........Q........+
+...........!!!!!...+
+...........!!I!!...+
+...........!!!!!...+
+.R.................+
+...................+
++++++++++=++++++++++