++++++++++-++++++++++
+...................+
+..C.............V..+
+...................+
+...................+
+......!OOOOO!......+
+......O.....O......+
<......O..Q..O......>
+......O.....O......+
+......!OOOOO!......+
+...................+
+...................+
+..P.............R..+
+...................+
++++++++++=++++++++++