++++++++++-++++++++++
+AG...............GA+
+GAG.............GAG+
+.GAG...........GAG.+
+..GAG.........GAG..+
+...GAGGGGGGGGGAG...+
+....GGKG...GKGG....+
<......G.....G......>
+....GGKG...GKGG....+
+...GAGGGGGGGGGAG...+
+..GAG.........GAG..+
+.GAG...........GAG.+
+GAG.............GAG+
+AG...............GA+
++++++++++=++++++++++