++++++++++-++++++++++
+A.................A+
+.A...............A.+
+..A.............A..+
+...A...........A...+
+....A.GGGGGGG.A....+
+......GK...KG......+
<......G.....G......>
+......GK...KG......+
+....A.GGGGGGG.A....+
+...A...........A...+
+..A.............A..+
+.A...............A.+
+A.................A+
++++++++++=++++++++++