++++++++++-++++++++++
+...................+
+...................+
+...................+
+...................+
+.........C.........+
+........OOO........+
<.......COQOC.......>
+........OOO........+
+.........C.........+
+...................+
+...................+
+...................+
+...................+
++++++++++=++++++++++