++++++++++-++++++++++
+...................+
+...................+
+...................+
+.........C.........+
+...................+
+........OOO........+
<......C.OQO.C......>
+........OOO........+
+...................+
+.........C.........+
+...................+
+...................+
+...................+
++++++++++=++++++++++