++++++++++-++++++++++
+..........D........+
+...................+
+...................+
+...................+
+...................+
+T..................+
<.........C.........>
+..................F+
+...................+
+...................+
+...................+
+...................+
+........U..........+
++++++++++=++++++++++