++++++++++-++++++++++
+...................+
+...................+
+...................+
+......AGGGGGA......+
+......G.....G......+
+......G.....G......+
<......G..Q..G......>
+......G.....G......+
+......G.....G......+
+......AGGGGGA......+
+...................+
+...................+
+...................+
++++++++++=++++++++++