++++++++++-++++++++++
+...................+
+...OOO.......OOO...+
+...................+
+...................+
+...................+
+...!...............+
<.........I.........>
+...................+
+........!...!......+
+...................+
+........!..........+
+...OOO.......OOO...+
+...................+
++++++++++=++++++++++