++++++++++
+........+
+........+
+...S....+
+........+
+........+
+........+
++++++++++