+++++++++++
+.........+
+..O...O..+
+.........+
+....I....+
+.........+
+..O...O..+
+.........+
+++++++++++