V+++++++++-+++++++++B
LQTTTTTTTTTTTTTTTTTWF
LP.................YF
LP..OOO.......OOO..YF
LP.................YF
LP.................YF
LP.................YF
<P........I........Y>
LP.................YF
LP.................YF
LP.................YF
LP..OOO.......OOO..YF
LP.................YF
LZUUUUUUUUUUUUUUUUUXF
MDDDDDDDDD=DDDDDDDDDN