+++++++++++++++++++++
+...................+
+...PPP.......PPP...+
+...................+
+...................+
+...................+
+.........I.........+
+...................+
+...................+
+...................+
+...................+
+...................+
+...PPP.......PPP...+
+...................+
+++++++++++++++++++++