++++++++++-++++++++++
+...................+
+....!.........!....+
+....!.........!....+
+...................+
+...................+
+...................+
<.........I.........>
+...................+
+...................+
+...................+
+.....P.......P.....+
+...................+
+...................+
++++++++++=++++++++++