++++++++++-++++++++++
+...................+
+.......WWWWW.......+
+.......WWWWW.......+
+...WWWW.....WWWW...+
+.WWR...........RWW.+
+.WW.............WW.+
<.WW......2......WW.>
+.WW.............WW.+
+.WWR...........RWW.+
+...WWWW.....WWWW...+
+.......WWWWW.......+
+.......WWWWW.......+
+...................+
++++++++++=++++++++++