++++++++++-++++++++++
+.......WWWWW.......+
+.......WWWWW.......+
+.......WWWWW.......+
+...WWWW.....WWWW...+
+WWWR...........RWWW+
+WWW.............WWW+
<WWW......C......WWW>
+WWW.............WWW+
+WWWR...........RWWW+
+...WWWW.....WWWW...+
+.......WWWWW.......+
+.......WWWWW.......+
+.......WWWWW.......+
++++++++++=++++++++++