++++++++++-++++++++++
+...................+
+...................+
+Z.......AAA.......X+
+....KGGGGAGGGGK....+
+....G.........G....+
+...AG.........G....+
<...AA....K....A....>
+...AG.........G....+
+....G.........G....+
+....KGGGGAGGGGK....+
+Z.......AAA.......X+
+...................+
+...................+
++++++++++=++++++++++