++++++++++-++++++++++
+.....Z.OH.HO.......+
+.......OH.HO.X.....+
+.......OH.HO.......+
+.......OH.HO.......+
+OOOOOOOOH.HOOOOOOOO+
+HHHHHHHHH.HHHHHHHHH+
<...................>
+HHHHHHHHH.HHHHHHHHH+
+OOOOOOOOH.HOOOOOOOO+
+.......OH.HO.......+
+.......OH.HO.......+
+.......OH.HO.X.....+
+.....Z.OH.HO.......+
++++++++++=++++++++++