++++++++++-++++++++++
+...................+
+...................+
+..V.....!.!.....R..+
+...!...........!...+
+...................+
+..!.............!..+
<...................>
+..!.............!..+
+...................+
+...!...........!...+
+..2.....!.!.....C..+
+...................+
+...................+
++++++++++=++++++++++