++++++++++-++++++++++
+...................+
+...................+
+..........C........+
+...................+
+...................+
+...................+
<..Q................>
+...................+
+...................+
+...................+
+...............C...+
+...................+
+...................+
++++++++++=++++++++++