++++++++++-++++++++++
+...................+
+.HH.............HH.+
+.HH.............HH.+
+...................+
+.........C.........+
+........HHH........+
<.......CHQHC.......>
+........HHH........+
+.........C.........+
+...................+
+.HH.............HH.+
+.HH.............HH.+
+...................+
++++++++++=++++++++++