++++++++++-++++++++++
+...................+
+.HH.............HH.+
+.HH.............HH.+
+.........C.........+
+...................+
+........HHH........+
<......2.HQH.2......>
+........HHH........+
+...................+
+.........C.........+
+.HH.............HH.+
+.HH.............HH.+
+...................+
++++++++++=++++++++++