++++++++++-++++++++++
+GGG.............GGG+
+GKG.............GKG+
+GGG.............GGG+
+...................+
+.........P.........+
+...................+
<.....P.......P.....>
+...................+
+.........P.........+
+...................+
+GGG.............GGG+
+GKG.............GKG+
+GGG.............GGG+
++++++++++=++++++++++