+++++++++++
+.........+
+..!...!..+
+.........+
+...OOO...+
+.........+
+..!...!..+
+.........+
+++++++++++