++++++++++-++++++++++
+...................+
+.........!.........+
+...................+
+...O...........O...+
+.........!.........+
+...................+
<...!...........!...>
+...................+
+.........!.........+
+...O...........O...+
+...................+
+.........!.........+
+...................+
++++++++++=++++++++++