V+++++++++-+++++++++B
LQTTTTTTTTTTTTTTTTTWF
LP.................YF
LP........!........YF
LP..O...........O..YF
LP........!........YF
LP.................YF
<P..!...........!..Y>
LP.................YF
LP........!........YF
LP..O...........O..YF
LP........!........YF
LP.................YF
LZUUUUUUUUUUUUUUUUUXF
MDDDDDDDDD=DDDDDDDDDN