++++++++++-++++++++++
+...................+
+....!.........!....+
+....!.........!....+
+...................+
+........C..........+
+...................+
<...................>
+.....OOOOOOOOO.....+
+...................+
+...................+
+...................+
+...................+
+...................+
++++++++++=++++++++++