xxxxxxxxxxxxxxxxxxxxx
x..,.............,..x
x..,.....0.......,..x
x..,.M.M.....M.M.,..x
x..,.............,..x
x..,,,,,,,,,,,,,,,..x
x.Y...............Y.x
x.........S.........x
x...................x
x...................x
x.........L.........x
x.....!!.!!!.!!.....x
x...................x
x...................x
xxxxxxxxxxxxxxxxxxxxx