++++++++++-++++++++++
+...................+
+....!.........!....+
+....!.........!....+
+....!.........!....+
+....M....M....M....+
+...................+
<.........S.....CR..>
+...................+
+..............GGG..+
+.........L.........+
+.....!!.!!!.!!.....+
+...................+
+...................+
++++++++++=++++++++++