+++++++++++++++++++++
+..,.............,..+
+..,.....0.......,..+
+..,.M.M.....M.M.,..+
+..,.............,..+
+..,,,,,,,,,,,,,,,..+
+.Y...............Y.+
+.........S.........+
+...................+
+...................+
+.........L.........+
+.....!!.!!!.!!.....+
+...................+
+...................+
+++++++++++++++++++++