+++++++++++++++++++++
+...................+
+.........!.........+
+...................+
+...O...........O...+
+.........!.........+
+...................+
+...!...........!...+
+...................+
+.........!.........+
+...O...........O...+
+...................+
+.........!.........+
+...................+
+++++++++++++++++++++