++++++++++-++++++++++
+...................+
+....!.........!....+
+....!.........!....+
+...................+
+...................+
+.........Q.........+
<...................>
+.......OOOOO.......+
+...................+
+...................+
+...................+
+...................+
+...................+
++++++++++=++++++++++