++++++++++-++++++++++
+...................+
+....!.........!....+
+....!.........!....+
+...................+
+...................+
+...................+
<...................>
+.......OOOOO.......+
+...................+
+...................+
+...................+
+....R.........R....+
+...................+
++++++++++=++++++++++