++++++++++-++++++++++
+...................+
+....!.........!....+
+....!....C....!....+
+...................+
+...................+
+...................+
<...................>
+.......OOOOO.......+
+...................+
+.........C.........+
+...................+
+...................+
+...................+
++++++++++=++++++++++