V+++++++++-+++++++++B
LQTTTTTTTTTTTTTTTTTWF
LP.................YF
LP........O........YF
LP..!...........!..YF
LP........O........YF
LP.................YF
<P..O...........O..Y>
LP.................YF
LP........O........YF
LP..!...........!..YF
LP........O........YF
LP.................YF
LZUUUUUUUUUUUUUUUUUXF
MDDDDDDDDD=DDDDDDDDDN