++++++++++-++++++++++
+...................+
+...................+
+.........R.........+
+...................+
+........OOO........+
+.....OOO...OOO.....+
<...................>
+...................+
+...................+
+.........R.........+
+...................+
+...................+
+...................+
++++++++++=++++++++++