++++++++++-++++++++++
+...................+
+...................+
+...................+
+...................+
+.........R.........+
+.....OOO...OOO.....+
<......OOOOOOO......>
+...................+
+...................+
+.........R.........+
+...................+
+...................+
+...................+
++++++++++=++++++++++