++++++++++-++++++++++
+...................+
+....!.........!....+
+....!.........!....+
+...................+
+...................+
+...........R.......+
<...................>
+.....OOOOOOOOO.....+
+...................+
+.......R...........+
+...................+
+...................+
+...................+
++++++++++=++++++++++