++++++++++-++++++++++
+HHHHHHH.....HHHHHHH+
+HHHHHHHH...HHHHHHHH+
+HHHHHHHH...HHHHHHHH+
+HHHHHHHH...HHHHHHHH+
+.HHHH.........HHHH.+
+...................+
<.........Q.........>
+...................+
+.HHHH.........HHHH.+
+HHHHHHHH...HHHHHHHH+
+HHHHHHHH...HHHHHHHH+
+HHHHHHHH...HHHHHHHH+
+HHHHHHH.....HHHHHHH+
++++++++++=++++++++++