++++++++++-++++++++++
+HHHHHHH.....HHHHHHH+
+HHHHHHHH...HHHHHHHH+
+HHHHHHHHH.HHHHHHHHH+
+HHHHHHHHH.HHHHHHHHH+
+.HHHH.........HHHH.+
+..HHH.........HHH..+
<...................>
+..HHH.........HHH..+
+.HHHH.........HHHH.+
+HHHHHHHHH.HHHHHHHHH+
+HHHHHHHHH.HHHHHHHHH+
+HHHHHHHH...HHHHHHHH+
+HHHHHHH.....HHHHHHH+
++++++++++=++++++++++