++++++++++-++++++++++
+HHHHHHH.....HHHHHHH+
+HHHHHHHH...HHHHHHHH+
+HHHHHHHHH.HHHHHHHHH+
+HHHHHHHHH.HHHHHHHHH+
+.HHHHHHHH.HHHHHHHH.+
+..HHH.........HHH..+
<.........Q.........>
+..HHH.........HHH..+
+.HHHHHHHH.HHHHHHHH.+
+HHHHHHHHH.HHHHHHHHH+
+HHHHHHHHH.HHHHHHHHH+
+HHHHHHHH...HHHHHHHH+
+HHHHHHH.....HHHHHHH+
++++++++++=++++++++++