++++++++++-++++++++++
+HHHHH!.......!HHHHH+
+HHHHH!.......!HHHHH+
+HHHH!!.WWWWW.!!HHHH+
+!!!!D!WWWWWWWF!!!!!+
+...W...........W...+
+..WW...........WW..+
<..WW...........WW..>
+..WW...........WW..+
+...W...........W...+
+!!!!!TWWWWWWW!U!!!!+
+HHHH!!.WWWWW.!!HHHH+
+HHHHH!.......!HHHHH+
+HHHHH!.......!HHHHH+
++++++++++=++++++++++