++++++++++-++++++++++
+HHHHH!.......!HHHHH+
+HHHHH!.......!HHHHH+
+HHHHH!.WWWWW.!HHHHH+
+HHHH!.WWWWWWWF!HHHH+
+!!!!D..........!!!!+
+..WW...........WW..+
<..WW...........WW..>
+..WW...........WW..+
+!!!!..........U!!!!+
+HHHH!TWWWWWWW.!HHHH+
+HHHHH!.WWWWW.!HHHHH+
+HHHHH!.......!HHHHH+
+HHHHH!.......!HHHHH+
++++++++++=++++++++++