++++++++++-++++++++++
+.HHH.!.......!.HHH.+
+HHHHH!.......!HHHHH+
+HHHHH!.WWWWW.!HHHHH+
+.HHH!.WWWWWWWF!HHH.+
+!!!!D..........!!!!+
+...WW..........WW..+
<...WW..........WW..>
+...WW..........WW..+
+!!!!..........U!!!!+
+.HHH!TWWWWWWW.!HHH.+
+HHHHH!.WWWWW.!HHHHH+
+HHHHH!.......!HHHHH+
+.HHH.!.......!.HHH.+
++++++++++=++++++++++