++++++++++-++++++++++
+HHGGGGGGG.GGGGGGGGH+
+!GGGGGGG!.GGGGG!G!H+
+GGGKGGGKG!GGGGGGGGG+
+GGGGG!GGGGGGGGGGG!G+
+!GGGGGGGGGGGGGGGGGG+
+!GGGGGGGGGGGGGGGGGG+
<..!GGGGKG!GGGGGG!..>
+!GGGGGGG!GGGGGG!GG!+
+HGGGGG!GGGGGGGGGGGG+
+H!GGGGGGGGGHHGGGKGG+
+H!GKGGGGGGGHHGGGGGG+
+HGGGGGGGG.!GGGGGGGG+
+HGGGGGGGG.!GG!GGGG!+
++++++++++=++++++++++