++++++++++-++++++++++
+!HGGGGGGG.GGGGG!.!H+
+GGGGGGGG!.GGGGGGGGH+
+GGGKGGGKG!GGGGGGG!H+
+GGGGG!GGGGGGGGGGGG!+
+!GGGGGGGGGGGGGGGGGG+
+!GGGGGGGGGGGGGGGG!G+
<..!GGGGKG!GGGGGG!..>
+!GGGGGGG!GGGGGG!G!G+
+HGGGGG!GGGGGGGGGGGG+
+H!GGGGGGGGGHHGGGKGG+
+H!GKGGGGGGGHHGGGGGG+
+H!GGGGGG!.!GGGGGGGG+
+HGGGGGGGG.!GG!GGGGG+
++++++++++=++++++++++