++++++++++-++++++++++
+!HGGGGGGG.GGGGG!.!H+
+.G......!.GGGGGGGGH+
+.G.K...K.!....G..!H+
+.G...!........G...!+
+!GGGGGGGGGGGGGGGGGG+
+!G...G........G..!G+
<..!..G.K.!....G.!..>
+!G...G..!GGGGGG!.!G+
+HGGGGG!..G....G...G+
+H!...G...G.HH.G.K.G+
+H!.K.G...G.HH.G...G+
+H!...G..!.!...G...G+
+HGGGGGGGG.!..!GGGGG+
++++++++++=++++++++++