++++++++++-++++++++++
+HHGGGGGGG.GGGGGGGGH+
+AGGGGGGGA.GGGGGAGAH+
+GGGKGGGGGAGGGGGGGGG+
+GGGGGAGKGGGGGGGGGAG+
+AGGGGGGGGGGGKGGGGGG+
+AGGGGGGGGGGGGGGGGGG+
<..AGGGGKGAGGGGGGA..>
+AGGGGGGGAGGGGGGAGGA+
+HGGGGGAGGGGGGGGGGGG+
+HAGGGGGGGGGHHGGGKGG+
+HAGKGGGGGGGHHGGGGGG+
+HGGGGGGGG.AGGGGGGGG+
+HGGGGGGGG.AGGAGGGGA+
++++++++++=++++++++++